█████████████████████████████████████████
█       █ █   █   █       █   █   █ █ █ █
███████ █ ███ ███ ███████ ███ ███ █ █ █ █
█ █     █ █ █   █ █   █ █   █ █     █ █ █
█ █████ █ █ ███ █ ███ █ ███ █ █████ █ █ █
█     █ █   █   █ █   █   █ █     █ █ █ █
█████ █ ███ ███ █ ███ ███ █ █████ █ █ █ █
█ █ █     █ █ █     █ █   █   █ █   █   █
█ █ █████ █ █ █████ █ ███ ███ █ ███ ███ █
█     █             █   █ █ █ █       █ █
█████ █████████████ ███ █ █ █ ███████ █ █
█ █ █ █ █   █   █ █   █ █ █ █   █   █ █ █
█ █ █ █ ███ ███ █ ███ █ █ █ ███ ███ █ █ █
█   █       █ █   █   █   █ █ █ █       █
███ ███████ █ ███ ███ ███ █ █ █ ███████ █
█     █ █       █ █ █   █ █ █ █ █ █   █ █
█████ █ ███████ █ █ ███ █ █ █ █ █ ███ █ █
█ █     █ █ █ █         █     █   █ █ █ █
█ █████ █ █ █ █████████ █████ ███ █ █ █ █
█                                       █
█████████████████████████████████████████
