█████████████████████████████████████████
█   █         █ █ █       █   █   █ █   █
█ █ ███ ███ ███ █ ███████ █ ███ ███ █ ███
█ █   █ █         █       █   █ █   █ █ █
███ ███ █ ███ █ █████ █ █ █ ███ █ █ █ █ █
█ █     █   █ █       █ █ █       █ █   █
█ █ ███ █ █████ █ █████ █ █ █ █ █ █ ███ █
█   █ █ █ █ █   █ █   █ █ █ █ █ █ █ █ █ █
█ ███ █ ███ ███ █ █ █ █ ███ █ ███ ███ █ █
█     █ █ █   █ █ █ █   █   █   █ █ █   █
█ █ ███ █ █ █████ █ █████ ███ ███ █ █ ███
█ █   █ █ █ █     █ █   █   █   █ █ █ █ █
███ █ █ █ █ █ █ █ ███ █████ █████ █ █ █ █
█ █ █ █     █ █ █   █ █   █ █   █ █ █   █
█ ███ █ █ ███ █ █ █ █ █ █████ ███ █ █ ███
█     █ █ █ █ █ █ █   █   █ █   █ █   █ █
█ █████ ███ █ █ ███████ ███ ███ █ █ ███ █
█ █ █   █ █ █ █ █     █ █   █       █   █
███ █ █ █ █ █ ███ █████ ███ ███ ███████ █
█ █ █ █ █   █   █ █   █   █ █   █       █
█ █ ███████ █ █ █ █ █████ █ ███ █ █████ █
█ █ █     █ █ █   █ █         █     █ █ █
█ █ █ █████ █ █████ █ ███ █ ███ █ ███ █ █
█ █ █       █ █ █ █ █   █ █ █   █     █ █
█ █ █ ███ █ █ █ █ █ █ ███ █████████ █ █ █
█ █ █   █ █ █     █ █ █ █     █ █   █ █ █
█ █ █ ███████ █████ ███ █ █████ █ ███ █ █
█       █   █   █ █     █ █ █   █ █ █ █ █
███ █████ ███ ███ ███ █ █ █ █ █ █ █ █████
█ █ █   █   █ █   █ █ █ █ █ █ █       █ █
█ █ █ ███ ███ █ █ █ ███ █ █ ███ █ ███ █ █
█ █ █     █     █ █ █ █   █     █   █   █
█ █ ███ ███ █████ █ █ █ █████ ███ █ █ █ █
█   █     █   █   █ █     █ █   █ █ █ █ █
███ █ █████ █████ █ █████ █ █ █ █ █ █ █ █
█ █           █   █ █ █ █   █ █ █ █ █ █ █
█ █ █ █ ███ ███ ███ █ █ █ █████ █ █ █ ███
█ █ █ █   █   █ █   █           █ █ █ █ █
█ █ █████ █████ █ █ ███ █ ███████████ █ █
█                 █     █ █             █
█████████████████████████████████████████
