█████████████████████
█ █ █ █   █       █ █
█ █ █ ███ ███████ █ █
█   █ █   █ █ █ █ █ █
███ █ ███ █ █ █ █ █ █
█ █ █ █     █ █     █
█ █ █ █████ █ █████ █
█ █   █           █ █
█ ███ ███████████ █ █
█ █   █ █     █ █   █
█ ███ █ █████ █ ███ █
█ █   █ █ █ █   █   █
█ ███ █ █ █ ███ ███ █
█ █   █ █ █   █ █ █ █
█ ███ █ █ ███ █ █ █ █
█ █ █ █     █ █     █
█ █ █ █████ █ █████ █
█ █ █ █   █   █     █
█ █ █ ███ ███ █████ █
█                   █
█████████████████████
