█████████████████████
█ █                 █
█ █████████████████ █
█       █ █   █   █ █
███████ █ ███ ███ █ █
█ █ █ █     █   █ █ █
█ █ █ █████ ███ █ █ █
█ █ █   █ █         █
█ █ ███ █ █████████ █
█   █   █   █   █ █ █
███ ███ ███ ███ █ █ █
█   █     █   █ █   █
███ █████ ███ █ ███ █
█ █ █     █ █   █   █
█ █ █████ █ ███ ███ █
█   █ █     █       █
███ █ █████ ███████ █
█   █ █ █ █   █ █   █
███ █ █ █ ███ █ ███ █
█                   █
█████████████████████
