█████████████████████
█ █ █     █ █ █ █   █
█ █ █████ █ █ █ ███ █
█ █         █ █ █   █
█ █████████ █ █ ███ █
█ █ █     █ █ █   █ █
█ █ █████ █ █ ███ █ █
█   █     █ █       █
███ █████ █ ███████ █
█ █ █   █     █     █
█ █ ███ █████ █████ █
█ █         █   █ █ █
█ █████████ ███ █ █ █
█   █   █ █       █ █
███ ███ █ ███████ █ █
█         █ █       █
█████████ █ ███████ █
█ █ █   █   █       █
█ █ ███ ███ ███████ █
█                   █
█████████████████████
